





R          800        600




                         NO ./ressources/brick_wall.xpm
         WE                     ./ressources/black_brick_wall.xpm
EA ./ressources/white_brick_wall.xpm

C               50,100,225
F 200,100,20





S   ./ressources/test.xpm

SO               ./ressources/brick_wall2.xpm


   11111111111111111111111111111111111111111111111111111
  1000000000000000000000000S0001100000000000000000000001
   10000000000000000000000000001102000000000000000000001
    1000001111111111000000000001100000000011111111000001
     10000000000001111110000000111110000001      1000001
1111111100002020201111000000000111110000001      1000001
10000000000000000011111100000001100000000011111111000001
10000000000111111110000000000001100200000000000000000001
10000000000000011000000000000001100000001000000000000001
1111111100001001100101010101010110000001 100000000000001
10000011110000011000000000000001100000001000000000000001
10020000000000011010101010101001100000000000000000000001
10000011110000000000000000000000000000000001111111111111
11111111000000011101010101010101100000000000000000000001
10000000000000011000000000000001100000000000000000000001
10011000111111111010101010101011100200000000200000020001
10011000000000011000000000000001100000000000000000000001
10000000000000011002020202020201100000000000100000000001
10011111111110011111110001111111100000000001 10000000001
1001100000000001000000000000000000000000001   1000000001
100000011111100002000000000000000000000001     100000001
10000000000000000000000000000000000000001       10000001
1111111111111111110000000000000000000001         1000001
110010001000100000000000000000000000001           100001
11000010001000111100000000000000000001             10001
11111111111111111111111111111111111111             11111

