R 3000000 3000000

                         NO ./ressources/brick_wall.xpm
SO               ./ressources/brick_wall2.xpm
         WE                     ./ressources/black_brick_wall.xpm
EA ./ressources/white_brick_wall.xpm
S ./ressources/barrel.xpm

C 70,100,225

F 200,150,20











        1111111111111111111111                        111
     11111 11000011100000000111    111      1111111111101111111
     1011111101111 10002000001     101                111
     1000000000001 10000000001     111
     1010000001111110001000001111
     1111000000000001111110011101111111111             111111111
       11111111011111111 11011100000000001             100000101
        111   101        1101110100011111111           111111111
     1111011111011 1111111000100100011111111111111
1111111111111111111111111111111111111111111111111111111111111111111
     1100000101011 1000000000010001111
     100020000000111011000N000000021
     1000000000001100100000000001111
     1000000111001110101110101100111
     11000111111011001011100011111
     1110111 1 1001101111110111
11111111000111111000000001101111111111
111    111111   11111111111111111  1111111111111111
