R 800 800
                         NO ./ressources/brick_wall.xpm
SO               ./ressources/brick_wall2.xpm
         WE                     ./ressources/black_brick_wall.xpm
EA ./ressources/white_brick_wall.xpm
S ./ressources/barrel.xpm

C 70,100,225

F 200,150,20












1111111111111111111111111111111111111111111111111
1002222222222222222222222222222222222222222222201
1000000000000000000000000000000000000000000000001
1000000000000000000000000000000000000000000000001
1000000000000000000000000000000000000000000000001
100000000000000000000000N000000000000000000000001
1020202020202020202020202020202020202020202020201
1000000000000000000000000000000000000000000000001
1222222222222222222222222222222222222222222222221
1111111111111111111111111111111111111111111111111
