R 800 600
                         NO ./ressources/brick_wall.xpm
         WE                     ./ressources/black_brick_wall.xpm
EA ./ressources/white_brick_wall.xpm

C 70,100,225

F 200,150,20





SO               ./ressources/brick_wall2.xpm


S ./ressources/barrel.xpm




1111111111111111111111111111111111111111111
1000000000000000000000000000000000000000001
10000000000000000000S0000000000000000000001
1000000000000000000000000000000000000000001
1000000000000000000000000000000000000000001
1000000000000000020020020000000000000000001
1111111111111111111111111111111111111111111
1000000000000000000000000000000000100000001
1011111001111000110000001110000000102000001
1011111001000020110000001111111100100000201
1000000001020000110200201000000000100000001
1011111111000000110000001000000000000000001
1111111111111111111111111111111111111111111
1000000000000000000000000000000000000000001
1020000000000000000000000000000000000000201
1000000000020202020202020202000000000000001
1020000000000000000000000000000000000000201
1000222222222222222222222222222222222220001
1000000000000000000000000000000000000000001
1111111111111111111111111111111111111111111