





R          800        600




                         NO ./ressources/brick_wall.xpm
         WE                     ./ressources/black_brick_wall.xpm
EA ./ressources/white_brick_wall.xpm

C               50,100,225
F 200,100,20





S   ./ressources/barrel.xpm

SO               ./ressources/brick_wall2.xpm


1111111111111111111111111111111111111111111
1000000000000000000000000000000000000000001
10000000000000000000S0000000000000000000001
1000000000000000000000000000000000000000001      11111111111111
1000000000000000000000000000000000000000001      10000000000011
1000000000000000020020022200000000000000001      11111110011111
1111111111111111111111111111111111111111111            1111
1000000000000000000000000000000000100000001
1011111001111000110000001110000000102000001
1011111001000020110000001111111100100000201
1000000001020000110200201000000000100000001
1011111111000000110000001000000000000000001       1111
1111111111111111111111111111111111111111111         11111111
1000000000000000000000000000000000000000001
1020000000000000000000000000000000000000201
1000000000020202020202020202000000000000001        111
1020000000000000000000000000000000000000201        10111
1000222222222222222222222222222222222220001    1111111
1000000000000000000000000000000000000000001
1111111111111111111100111111111111111111111
                   1001
                   1001
                   1111


