R 800 600

                         NO ./ressources/alien.xpm
SO               ./ressources/alien.xpm
         WE                     ./ressources/alien.xpm
EA ./ressources/alien.xpm
S ./ressources/alien.xpm

C 70,100,225

F 200,150,20



        1111111111111111111111                        111
     11111 11000011100000000111    111      1111111111101111111
     1011111101111 10002000001     101                111
     1000000000001 10000000001     111
     1010000001111110001000001111
     1111000000000001111110011101111111111             111111111
       11111111011111111 11011100000000001             100000101
        111   101        1101110100011111111           111111111
     1111011111011 1111111000100100011111111111111
     1100000101011 1000000000010001111
1111111111111111111111111111111111111111111111111111111111111111111111111
1                                                                                1
1                                                                                1
1                                     11111                                           1
1                                     10001                                           1
1                                     11111                                           1
1                                                                                1
1111111111111111111111111111111111111111111111111111111111111111111111111
     1000200000001110110000000000021
     10000000000011001000W0000001111
     1000000111001110101110101100111
     11000111111011001011110011111
     1110111 1 1001101111110111
11111111000111111000000001101111111111
111    111111   11111111111111111  1111111111111111
